2
0 0 0 0 2 2 2 2 2 2 2 2 2 2 2 2 2 2 2 2
2 2 2 0 0 0 0 0 0 0 0 0 0 0 0 0 0 0 0 2
2 1 2 0 0 2 2 2 2 2 2 2 2 0 2 2 2 2 0 2
2 0 2 0 0 2 0 0 0 0 0 2 0 0 2 0 0 2 0 2
2 0 2 2 2 2 2 2 0 0 0 2 2 2 0 0 0 2 0 2
2 0 0 0 0 2 0 2 0 0 0 0 0 0 0 0 0 2 0 2
2 0 0 0 0 2 0 2 0 0 0 0 0 0 0 0 0 0 0 2
2 0 0 0 0 2 0 2 0 0 2 2 2 2 2 2 2 2 2 2
2 0 0 0 0 2 0 2 0 0 2 0 0 0 0 0 0 0 2 2
2 0 0 0 0 2 0 2 0 0 2 0 0 0 0 0 0 0 2 2
2 0 0 0 0 2 0 2 2 0 2 0 0 0 0 0 0 0 2 2
2 0 0 0 0 2 0 0 0 0 0 0 0 0 0 0 0 0 2 2
2 0 0 0 0 2 0 2 2 2 2 2 0 0 0 0 0 0 2 2
2 0 0 0 0 0 0 0 0 0 0 0 0 0 0 0 0 0 2 2
2 2 2 2 2 2 2 2 2 2 2 2 2 2 2 2 2 2 2 2

3 3 3 3 9 3 3 4 9 9 9 9 9 9 9 9 9 9 9 9
9 9 9 3 3 3 3 3 3 3 3 4 4 4 4 4 4 4 4 9
9 1 9 4 3 9 9 9 9 9 9 9 9 3 9 9 9 9 3 9
9 3 9 3 3 9 3 3 3 3 3 9 3 3 9 4 4 9 4 9
9 3 9 9 9 9 9 9 3 3 3 9 9 9 3 3 3 9 4 9
9 4 4 4 4 9 3 9 3 3 4 3 3 3 3 3 3 9 3 9
9 4 4 4 4 9 4 9 4 4 3 4 4 4 4 4 4 4 4 9
9 3 3 3 3 9 3 9 3 3 9 9 9 9 9 9 9 9 9 9
9 3 3 3 3 9 3 9 3 3 9 3 3 3 3 3 3 3 9 9
9 3 3 4 4 9 4 9 4 4 9 4 4 4 10 4 4 4 9 9
9 4 8 4 4 9 4 9 9 4 9 4 4 4 4 4 4 4 9 9
9 4 4 4 4 9 4 4 4 4 4 4 4 4 4 4 4 4 9 9
9 4 4 4 4 9 4 9 9 9 9 9 4 4 4 4 4 4 9 9
9 4 4 4 4 4 4 3 3 3 3 3 3 3 3 3 3 3 9 9
9 9 9 9 9 9 9 9 9 9 9 9 9 9 9 9 9 9 9 9